XXXXXX
XHXXXX
X*PX X
XXPX X
XPPPPX
XXXXXX